221400000018826628810000004122
221400000018826628810000004122
111400000011121121110000004111
444400000000447744000000004444
000000000000447744000000000000
000000000000444444000000000000
000033333333332233333333330000
000032222222211112222222230000
000055555555555555555555550000
000055555555555555555555550000
000032222222211112222222230000
000033333333332233333333330000
000000000000444444000000000000
000000000000447744000000000000
444400000000447744000000004444
111400000011121121110000004111
221400000018826628810000004122
221400000018826628810000004122