884000000555557755555000000488
884000000555557755555000000488
444000000555555555555000000444
000000000553331133355000000000
000000000553221122355000000000
555555555553211112355555555555
555555555553216612355555555555
553333333333216612333333333355
551111111111222222111111111155
551111111111222222111111111155
553333333333216612333333333355
555555555553216612355555555555
555555555553211112355555555555
000000000553221122355000000000
000000000553331133355000000000
444000000555555555555000000444
884000000555557755555000000488
884000000555557755555000000488