772661400000000000000000388488
772661400000000000000000388488
002111400000033333333333344444
002004400000030000000000000000
002004444444430000000000000000
002000000000011113333333333333
002000000000011110000000000000
002222222222211112222222222222
000000000000111111000000000000
000000000000111111000000000000
222222222222211112222222222200
000000000000011110000000000200
333333333333311110000000000200
000000000000000034444444400200
000000000000000030000004400200
444443333333333330000004111200
884883000000000000000004166277
884883000000000000000004166277