000000011188326623881110000000
000000011188326623881110000000
000000011111132231111110000000
000000011111137731111110000000
000000011111137731111110000000
000000000000000000000000000000
000000000000000000000000000000
000000000000000000000000000000
000000000000000000000000000000
000000000000000000000000000000
000000000000000000000000000000
000000000000000000000000000000
000000000000000000000000000000
000000011111137731111110000000
000000011111137731111110000000
000000011111332233111110000000
000000011188326623881110000000
000000011188326623881110000000