880000000444444444444000001166
880000000444444444444000001166
770000000555555555555000001111
770000000555555555555000001111
000000000333111111333000000088
000000000003000000300000000088
444444444403000000304444444444
333333333403002200304333333333
333333333403022220304333333333
333333333403022220304333333333
333333333403002200304333333333
444444444403000000304444444444
880000000003000000300000000000
880000000333111111333000000000
111100000555555555555000000077
111100000555555555555000000077
661100000444444444444000000088
661100000444444444444000000088